2 13 31
###############################
#p                            #
#   ************************  #
#   *        1 2 3         *   #
#   *                      *  #
#   *                      *  #
#   *                      *  #
#   *                      *  #
#   *                      *  #
#   *                      *  #
#   ************************  #
#                             #
###############################