2 13 31
###############################
#p                 23         #
#   ************************  #
#   *                      *  #
#   *                      *  #
#   *              1       *  #
#   *                      *  #
#   *                      *  #
#   *                      *  #
#   *                      *  #
#   ************************  #
#                             #
###############################